//MAP CONVERTED BY dmm2tgm.py THIS HEADER COMMENT PREVENTS RECONVERSION, DO NOT REMOVE
"ag" = (
/obj/effect/decal/bordur{
	dir = 1
	},
/turf/open/floor/plating/roofwalk,
/area/space)
"bf" = (
/obj/effect/decal/bordur{
	dir = 8
	},
/obj/effect/decal/bordur,
/turf/open/floor/plating/roofwalk,
/area/space)
"bP" = (
/obj/structure/toilet,
/turf/open/floor/plating/concrete,
/area/space)
"bS" = (
/obj/effect/decal/pallet,
/obj/structure/closet/crate/large,
/obj/structure/closet/crate/large,
/turf/open/floor/plating/concrete,
/area/space)
"cv" = (
/obj/effect/spawner/random/trash/mess,
/turf/open/floor/plating/sidewalk,
/area/space)
"ea" = (
/obj/structure/roofstuff,
/turf/open/floor/plating/roofwalk,
/area/space)
"en" = (
/obj/effect/turf_decal/trimline/yellow/warning{
	dir = 5
	},
/turf/open/floor/plating/vampplating/mono,
/area/vtm/interior/shop)
"eO" = (
/obj/structure/table,
/turf/open/floor/plating/vampplating,
/area/vtm/interior/shop)
"eR" = (
/obj/structure/vampfence{
	dir = 8
	},
/turf/open/floor/plating/concrete,
/area/space)
"gi" = (
/obj/structure/vampdoor/glass,
/turf/open/floor/plating/vampplating,
/area/vtm/interior/shop)
"hO" = (
/obj/structure/vampfence/corner{
	dir = 8
	},
/turf/open/floor/plating/concrete,
/area/space)
"iR" = (
/obj/effect/decal/pallet,
/obj/structure/closet/crate/large,
/turf/open/floor/plating/concrete,
/area/space)
"iZ" = (
/obj/structure/table,
/obj/machinery/light{
	dir = 8
	},
/turf/open/floor/plating/vampplating/mono,
/area/vtm/interior/shop)
"jM" = (
/obj/structure/chair/wood,
/turf/open/floor/plating/concrete,
/area/space)
"kE" = (
/obj/structure/rack,
/turf/open/floor/plating/vampplating/mono,
/area/vtm/interior/shop)
"na" = (
/obj/structure/fence/door/opened{
	dir = 8
	},
/turf/open/floor/plating/concrete,
/area/space)
"nv" = (
/obj/structure/fence/door/opened,
/turf/open/floor/plating/concrete,
/area/space)
"oF" = (
/obj/structure/vampdoor/npc,
/turf/open/floor/plating/parquetry/old,
/area/vtm/interior/shop)
"oH" = (
/obj/structure/closet/crate/bin,
/turf/open/floor/plating/concrete,
/area/space)
"oS" = (
/obj/structure/closet/crate/large,
/obj/item/wrench,
/obj/item/radio,
/obj/item/stock_parts/water_recycler,
/obj/item/stack/cable_coil/five,
/obj/item/melee/vampirearms/tire,
/obj/item/wallframe/picture,
/obj/item/paint/paint_remover,
/obj/item/stack/sticky_tape,
/obj/item/fish_feed,
/obj/item/kitchen/spoon,
/obj/item/kitchen/spoon,
/obj/item/kitchen/spoon,
/obj/item/reagent_containers/spray/pestspray,
/obj/item/chisel,
/obj/item/stock_parts/cell,
/obj/item/vending_refill/coffee,
/obj/item/reagent_containers/food/condiment/saltshaker,
/obj/item/reagent_containers/food/condiment/peppermill,
/turf/open/floor/plating/parquetry/old,
/area/vtm/interior/shop)
"pY" = (
/obj/effect/decal/bordur{
	dir = 10
	},
/turf/open/floor/plating/roofwalk,
/area/space)
"qP" = (
/turf/open/floor/plating/roofwalk,
/area/space)
"re" = (
/obj/effect/decal/trash{
	icon_state = "trash8"
	},
/obj/structure/closet/crate/dumpster,
/turf/open/floor/plating/sidewalk,
/area/space)
"sm" = (
/obj/item/kirbyplants/random{
	pixel_x = 9;
	pixel_y = 5
	},
/obj/item/kirbyplants/random{
	pixel_x = 8;
	pixel_y = 18
	},
/turf/open/floor/plating/concrete,
/area/space)
"sv" = (
/obj/flag/usa{
	pixel_y = 27
	},
/turf/open/floor/plating/vampplating,
/area/vtm/interior/shop)
"sH" = (
/turf/open/openspace,
/area/space)
"uz" = (
/obj/item/melee/vampirearms/brick{
	pixel_x = -8;
	pixel_y = -7
	},
/turf/open/floor/plating/concrete,
/area/space)
"vE" = (
/obj/effect/decal/bordur,
/turf/open/floor/plating/roofwalk,
/area/space)
"vS" = (
/obj/structure/closet/crate/large,
/obj/item/storage/toolbox/mechanical{
	pixel_y = -2;
	pixel_x = -2
	},
/obj/item/storage/toolbox/electrical{
	pixel_x = 2;
	pixel_y = 5
	},
/turf/open/floor/plating/parquetry/old,
/area/vtm/interior/shop)
"wi" = (
/obj/structure/bricks,
/turf/open/floor/plating/concrete,
/area/space)
"wA" = (
/obj/structure/rack,
/obj/effect/spawner/random/engineering/material_cheap,
/obj/effect/spawner/random/engineering/material_cheap,
/turf/open/floor/plating/vampplating/mono,
/area/vtm/interior/shop)
"wK" = (
/obj/effect/decal/pallet,
/turf/open/floor/plating/concrete,
/area/space)
"xB" = (
/obj/structure/vampfence,
/turf/open/floor/plating/concrete,
/area/space)
"xR" = (
/obj/structure/rack,
/obj/effect/spawner/random/engineering/tool,
/obj/effect/spawner/random/engineering/tool,
/turf/open/floor/plating/vampplating/mono,
/area/vtm/interior/shop)
"xT" = (
/obj/effect/decal/bordur{
	dir = 8
	},
/turf/open/floor/plating/roofwalk,
/area/space)
"Ao" = (
/obj/effect/decal/pallet,
/obj/structure/closet/cardboard,
/turf/open/floor/plating/concrete,
/area/space)
"Av" = (
/turf/open/floor/plating/vampplating,
/area/space)
"AL" = (
/obj/effect/decal/bordur{
	dir = 8
	},
/obj/effect/decal/bordur{
	dir = 1
	},
/turf/open/floor/plating/roofwalk,
/area/space)
"Cf" = (
/obj/structure/table,
/obj/structure/table,
/obj/machinery/mineral/equipment_vendor/fastfood/clothing,
/turf/open/floor/plating/vampplating,
/area/vtm/interior/shop)
"CN" = (
/obj/structure/table,
/obj/structure/frame/machine,
/turf/open/floor/plating/vampplating/mono,
/area/vtm/interior/shop)
"Dc" = (
/obj/structure/closet/crate/dumpster,
/turf/open/floor/plating/sidewalk,
/area/space)
"DD" = (
/obj/structure/chair/wood{
	dir = 1
	},
/turf/open/floor/plating/parquetry/old,
/area/vtm/interior/shop)
"FP" = (
/obj/structure/rack,
/obj/effect/spawner/random/engineering/material,
/turf/open/floor/plating/vampplating/mono,
/area/vtm/interior/shop)
"Gf" = (
/obj/structure/table,
/obj/effect/turf_decal/trimline/yellow/warning{
	dir = 1
	},
/obj/machinery/light{
	dir = 8
	},
/turf/open/floor/plating/vampplating/mono,
/area/vtm/interior/shop)
"GX" = (
/obj/structure/vampfence/corner,
/turf/open/floor/plating/concrete,
/area/space)
"Ho" = (
/turf/open/floor/plating/parquetry/old,
/area/vtm/interior/shop)
"Jq" = (
/obj/structure/closet/crate/large,
/obj/item/melee/vampirearms/chainsaw,
/turf/open/floor/plating/parquetry/old,
/area/vtm/interior/shop)
"JG" = (
/obj/item/kirbyplants/random{
	pixel_x = 9;
	pixel_y = 3
	},
/obj/item/kirbyplants/random{
	pixel_x = 8;
	pixel_y = 18
	},
/turf/open/floor/plating/concrete,
/area/space)
"Kz" = (
/obj/structure/table/wood,
/obj/structure/showcase/machinery/tv{
	pixel_x = 2;
	pixel_y = 19
	},
/turf/open/floor/plating/parquetry/old,
/area/vtm/interior/shop)
"KB" = (
/obj/structure/table/wood,
/obj/effect/spawner/random/engineering/toolbox,
/turf/open/floor/plating/parquetry/old,
/area/vtm/interior/shop)
"Mc" = (
/obj/structure/chair/wood{
	dir = 8
	},
/turf/open/floor/plating/concrete,
/area/space)
"Mt" = (
/turf/closed/wall/vampwall,
/area/space)
"MT" = (
/obj/structure/vampdoor/glass{
	dir = 1
	},
/turf/open/floor/plating/vampplating,
/area/vtm/interior/shop)
"Nj" = (
/obj/structure/bookcase/manuals/engineering,
/turf/open/floor/plating/parquetry/old,
/area/vtm/interior/shop)
"Ow" = (
/turf/open/floor/plating/concrete,
/area/space)
"Ox" = (
/obj/structure/table/wood,
/obj/item/paper{
	pixel_x = 1;
	pixel_y = 7
	},
/obj/item/paper{
	pixel_y = 5;
	pixel_x = 10
	},
/obj/item/paper{
	pixel_y = 1;
	pixel_x = -8
	},
/obj/item/flashlight/lamp{
	pixel_y = 12;
	pixel_x = -9
	},
/obj/item/paper{
	pixel_y = 3;
	pixel_x = -3
	},
/obj/effect/spawner/random/bureaucracy/folder,
/turf/open/floor/plating/parquetry/old,
/area/vtm/interior/shop)
"PJ" = (
/turf/open/floor/plating/sidewalk,
/area/space)
"PN" = (
/obj/effect/decal/bordur,
/obj/effect/decal/bordur{
	dir = 8
	},
/turf/open/floor/plating/roofwalk,
/area/space)
"Rb" = (
/obj/effect/decal/litter,
/turf/open/floor/plating/concrete,
/area/space)
"RM" = (
/obj/structure/toilet{
	dir = 1
	},
/turf/open/floor/plating/concrete,
/area/space)
"RY" = (
/obj/machinery/camera/directional/east,
/obj/effect/spawner/random/trash/bin,
/turf/open/floor/plating/concrete,
/area/space)
"Sz" = (
/obj/machinery/light{
	pixel_y = 32
	},
/turf/open/floor/plating/vampplating,
/area/vtm/interior/shop)
"SL" = (
/turf/open/floor/plating/vampplating,
/area/vtm/interior/shop)
"To" = (
/turf/closed/wall/vampwall,
/area/vtm/interior/shop)
"Tp" = (
/obj/structure/vampdoor/glass{
	dir = 4
	},
/turf/open/floor/plating/vampplating,
/area/vtm/interior/shop)
"Uk" = (
/obj/structure/rack,
/obj/item/flashlight,
/obj/item/flashlight,
/obj/effect/spawner/random/engineering/flashlight,
/turf/open/floor/plating/vampplating/mono,
/area/vtm/interior/shop)
"Uw" = (
/obj/structure/fence/door/opened{
	dir = 4
	},
/turf/open/floor/plating/concrete,
/area/space)
"Vk" = (
/obj/effect/turf_decal/trimline/yellow/warning{
	dir = 4
	},
/turf/open/floor/plating/vampplating/mono,
/area/vtm/interior/shop)
"Xg" = (
/obj/structure/table,
/obj/vampire_computer,
/turf/open/floor/plating/vampplating,
/area/vtm/interior/shop)
"XU" = (
/obj/structure/chair/wood{
	dir = 4
	},
/turf/open/floor/plating/concrete,
/area/space)
"Yl" = (
/obj/structure/chair/wood{
	dir = 8
	},
/mob/living/carbon/human/npc/shop,
/turf/open/floor/plating/vampplating,
/area/vtm/interior/shop)
"Zy" = (
/obj/structure/table/wood,
/obj/vampire_computer,
/turf/open/floor/plating/parquetry/old,
/area/vtm/interior/shop)
"ZQ" = (
/turf/closed/wall/vampwall/old/low/window,
/area/vtm/interior/shop)

(1,1,1) = {"
PJ
PJ
PJ
PJ
PJ
PJ
PJ
PJ
PJ
PJ
PJ
PJ
PJ
PJ
PJ
"}
(2,1,1) = {"
PJ
GX
xB
xB
xB
Uw
na
xB
xB
xB
xB
hO
PJ
PJ
PJ
"}
(3,1,1) = {"
PJ
eR
bS
iR
wK
Ow
Ow
wi
wi
iR
Ao
eR
PJ
PJ
PJ
"}
(4,1,1) = {"
PJ
eR
Rb
Ow
Ow
Ow
Ow
Ow
uz
Ow
Ow
nv
PJ
PJ
PJ
"}
(5,1,1) = {"
PJ
eR
oH
oH
RY
Ow
Ow
Ow
Ow
Ow
Ow
nv
PJ
PJ
PJ
"}
(6,1,1) = {"
cv
To
To
To
To
Ow
Ow
Ow
XU
Mc
RM
eR
re
PJ
PJ
"}
(7,1,1) = {"
PJ
oF
Ho
oS
To
JG
sm
Ow
jM
XU
bP
eR
Dc
PJ
PJ
"}
(8,1,1) = {"
PJ
To
Ho
Jq
To
ZQ
ZQ
Tp
ZQ
ZQ
To
To
To
To
PJ
"}
(9,1,1) = {"
PJ
To
Ho
Ho
To
SL
SL
SL
SL
SL
Gf
CN
iZ
ZQ
PJ
"}
(10,1,1) = {"
PJ
To
Nj
Ho
To
sv
SL
SL
SL
SL
en
Vk
Vk
ZQ
PJ
"}
(11,1,1) = {"
PJ
To
vS
Ho
To
Sz
eO
Cf
SL
SL
SL
SL
SL
gi
PJ
"}
(12,1,1) = {"
PJ
To
Ox
Ho
oF
SL
Yl
eO
SL
SL
SL
SL
SL
MT
PJ
"}
(13,1,1) = {"
PJ
To
Zy
DD
To
SL
SL
eO
SL
Uk
xR
kE
SL
ZQ
PJ
"}
(14,1,1) = {"
PJ
To
Kz
KB
To
SL
SL
Xg
SL
FP
kE
wA
SL
ZQ
PJ
"}
(15,1,1) = {"
PJ
To
To
To
To
To
To
To
Sz
SL
SL
SL
SL
To
PJ
"}
(16,1,1) = {"
PJ
Mt
Av
Av
Av
Av
Av
To
SL
SL
SL
SL
SL
To
PJ
"}
(17,1,1) = {"
PJ
Mt
Av
Av
Av
Av
Av
To
kE
kE
kE
kE
kE
To
PJ
"}
(18,1,1) = {"
PJ
Mt
Av
Av
Av
Av
Av
To
To
To
To
To
To
To
PJ
"}
(19,1,1) = {"
PJ
Mt
Mt
Av
Mt
Mt
Mt
Mt
Av
Av
Av
Av
Av
Mt
PJ
"}

(1,1,2) = {"
sH
sH
sH
sH
sH
sH
sH
sH
sH
sH
sH
sH
sH
sH
sH
"}
(2,1,2) = {"
sH
sH
sH
sH
sH
sH
sH
sH
sH
sH
sH
sH
sH
sH
sH
"}
(3,1,2) = {"
sH
sH
sH
sH
sH
sH
sH
sH
sH
sH
sH
sH
sH
sH
sH
"}
(4,1,2) = {"
sH
sH
sH
sH
sH
sH
sH
sH
sH
sH
sH
sH
sH
sH
sH
"}
(5,1,2) = {"
sH
sH
sH
sH
sH
sH
sH
sH
sH
sH
sH
sH
sH
sH
sH
"}
(6,1,2) = {"
sH
AL
xT
xT
PN
sH
sH
sH
sH
sH
sH
sH
sH
sH
sH
"}
(7,1,2) = {"
sH
ag
qP
qP
vE
sH
sH
sH
sH
sH
sH
sH
sH
sH
sH
"}
(8,1,2) = {"
sH
ag
qP
qP
pY
xT
xT
xT
xT
xT
xT
xT
xT
bf
sH
"}
(9,1,2) = {"
sH
ag
qP
qP
qP
qP
qP
qP
qP
qP
qP
qP
qP
vE
sH
"}
(10,1,2) = {"
sH
ag
qP
qP
qP
qP
qP
qP
qP
qP
qP
qP
qP
vE
sH
"}
(11,1,2) = {"
sH
ag
qP
qP
qP
qP
qP
qP
qP
qP
qP
qP
ea
vE
sH
"}
(12,1,2) = {"
sH
ag
qP
qP
qP
qP
qP
qP
qP
qP
qP
qP
qP
vE
sH
"}
(13,1,2) = {"
sH
ag
qP
qP
qP
qP
qP
qP
qP
qP
qP
qP
ea
vE
sH
"}
(14,1,2) = {"
sH
ag
qP
qP
qP
qP
qP
qP
qP
qP
qP
qP
qP
vE
sH
"}
(15,1,2) = {"
sH
ag
qP
qP
qP
qP
qP
qP
qP
qP
qP
qP
ea
vE
sH
"}
(16,1,2) = {"
sH
ag
qP
qP
qP
qP
qP
qP
qP
qP
qP
qP
qP
vE
sH
"}
(17,1,2) = {"
sH
ag
qP
qP
qP
qP
qP
qP
qP
qP
qP
qP
ea
vE
sH
"}
(18,1,2) = {"
sH
ag
qP
qP
qP
qP
qP
qP
qP
qP
qP
qP
qP
vE
sH
"}
(19,1,2) = {"
sH
ag
qP
qP
qP
qP
qP
qP
qP
qP
qP
qP
qP
vE
sH
"}
